XXXXXXXXXXXXXXXXXXXXXXXXXXXXXXXXXXXXXXXXXXXXXXXXXXXXXXXXXXXXX
P     X       X         X X       X   X     X       X   X   X
X X X X XXXXXXX X XXXXX X X X XXX X X X X X X XXXXXXX X X X X
X X X   X     X X X     X X X   X X X   X X X X       X   X X
XXX X XXX XXX X X X XXXXX X XXX X X XXXXX X X X XXXXXXXXXXX X
X   X X   X X   X X   X       X X X   X   X   X X         X X
X XXX X XXX XXXXX XXX XXXXXXXXX X XXX X XXXXX X XXXXXXX X X X
X   X X X     X   X X       X   X   X X   X   X X       X X X
XXX X X XXX X X XXX XXXXXXX X XXX XXX XXX X XXX X XXX XXXXX X
X   X X   X X X X       X   X X   X   X   X   X X   X X   X X
X XXXXXXX XXX X XXXXX XXX XXX X XXX XXX XXXXXXX XXX X X X X X
X     X       X X   X X   X   X   X   X         X   X X X   X
X XXX X XXXXXXX X X X X XXX XXX XXXXX XXXXXXXXXXX XXX X XXX X
X X X   X     X   X X   X   X   X   X X     X     X   X X   X
X X XXXXX XXX XXX X X XXX X XXXXX X X X XXX XXX X XXXXX X XXX
X X X     X X   X X X X   X X     X X X X X     X X     X X X
X X X XXXXX XXX XXX X XXXXX X XXXXX X X X XXXXX XXX XXXXX X X
X X X   X     X   X X     X     X   X   X       X   X   X X X
X X XXX X X X XXX X XXXXX XXXXXXX XXXXXXX XXXXXXX XXX X X X X
X X   X X X X   X X X   X X     X X     X       X   X X     X
X X XXX X X XXXXXXX X X X X XXX X X XXX XXXXXXX XXX XXXXXXXXX
X   X   X X         X X X   X X X X   X     X   X   X       X
XXX X XXXXX XXX XXXXX XXXXXXX X X XXX X XXX X XXX XXX XXXXX X
X   X     X   X X           X   X X   X X X X   X     X     X
X XXXXXXX XXXXX XXXXXXX X XXX XXX X XXX X X XXX XXXXXXX XXX X
X X   X   X     X     X X     X   X X X X X X X X X     X   X
X X XXX XXX XXXXX XXX XXXXX XXX X X X X X X X X X X XXXXX XXX
X   X   X X       X X     X X   X X   X X     X   X   X X X X
X XXX XXX X XXXXXXX XXXXX X X XXX XXX X X XXXXX XXXXX X X X X
X X   X     X   X       X X X X   X   X X X     X     X     X
X X XXX XXXXX X XXXXX XXX X X X XXX XXX XXX XXXXX XXXXXXXXX X
X X   X       X       X   X X X     X X         X X       X X
X XXX XXXXXXXXXXXXX XXX XXX X XXXXXXX XXXXXXXXX X X XXXXX X X
X   X   X         X X   X X X         X   X   X X X   X   X X
XXX XXX X XXXXXXXXX X XXX X XXXXXXXXX X XXX X X X XXX X XXX X
X     X X     X     X X     X     X     X   X X X X   X X   X
XXXXXXX XXXXX X XXXXX X XXXXX X XXX XXXXX XXX XXX X XXX XXXXX
X   X   X     X X     X X   X X     X   X   X   X X X X     X
X X X XXX X XXX X XXXXX XXX X XXXXXXX X XXX XXX X X X XXXXX X
X X   X   X X   X X   X X   X X   X   X   X   X X       X   X
X XXXXX X XXX XXX X XXX X XXX X XXX XXXXX XXX X XXXXXXX X XXX
X X   X X     X   X X   X     X   X X       X X   X     X   X
X X X XXXXXXXXX XXX X XXXXX XXX X X XXXXXXX X XXX X XXXXXXX X
X   X X   X     X   X     X   X X X X     X   X X X X     X X
XXXXX X X X XXXXXXX XXXXX XXX XXX X X XXX XXXXX X X XXX XXX X
X   X X X   X     X     X   X X   X X X X X   X X X   X   X X
X X X X XXXXX X X XXX XXXXX X X X X X X X X X X X XXX XXX X X
X X   X   X   X X     X     X   X X X   X   X X     X     X X
X XXXXX X X XXX XXXXX X XXXXX XXXXX XXX XXXXX XXXXX XXXXXXX X
X X     X X   X X   X X     X X   X     X   X   X X       X X
X XXX XXX XXXXX X X X XXXXX X X X XXX XXXXX XXX X XXXXXXX X X
X   X   X     X X X       X X X X   X     X   X X       X   X
XXX XXXXX XXX X X XXXXXXXXX X X XXX XXXXX XXX X XXX X XXXXX X
X X X   X X   X X     X   X X X   X   X X X   X   X X X     X
X X X X X X XXX XXXXXXX X X XXXXX XXX X X X X XXX X X X XXXXX
X X   X X X X   X       X X     X X X X     X X   X X   X   X
X XXXXX XXX XXX X XXXXXXX XXXXX X X X XXXXXXXXX XXX XXXXX X X
X     X   X   X X X           X X X X         X X X       X X
X XXXXXXX XXX X X X XXXXXXXXXXX X X XXXXXXXXX X X XXXXXXXXX X
X             X   X               X             X           K
XXXXXXXXXXXXXXXXXXXXXXXXXXXXXXXXXXXXXXXXXXXXXXXXXXXXXXXXXXXXX
