XXXXXXXXXXXXXXXXXXXXXXXXXXXXXXXXXXXXXXXXXXXXXXXXXXXXXXXXXXXXX
P         X         X     X                   X         X   X
X X XXX XXX XXXXX X X XXXXX XXXXXXXXX XXXXXXX X XXX XXX XXX X
X X X   X   X     X X   X   X   X   X X     X X X   X X     X
X X XXX X XXX XXXXX XXX X XXX X X X X X XXX X XXX XXX XXXXX X
X X   X X   X X     X   X X   X X X   X   X X     X     X X X
X XXX XXX XXX X XXXXX XXX X XXX X XXXXXXX X XXXXXXX X X X X X
X X X X   X   X     X X   X   X X X     X X   X X   X X   X X
X X X X XXX XXXXXXX X X XXXXX XXX X X XXX XXX X X XXX XXX X X
X   X     X X         X     X X   X X X   X   X     X X   X X
XXXXXXXXXXX XXXXXXXXXXXXXXX X X XXX X X XXX XXX XXXXX X XXX X
X           X   X         X   X     X   X   X   X     X X   X
X XXX XXXXXXX X X XXXXXXX XXX XXXXXXX XXX XXX XXX XXXXX X XXX
X   X X     X X   X     X     X     X X   X X X X     X X   X
XXX X X XXX X XXXXX XXX XXXXXXX XXX XXX XXX X X XXXXX XXXXX X
X   X X X X   X   X X X X   X   X X     X     X     X       X
X XXXXX X XXXXX X X X X X X X XXX XXXXXXX XXXXXXXXX XXXXXXXXX
X             X X X X X X X   X           X         X       X
XXXXXXXXXXXXXXX X X X X X XXXXX XXXXXXXXXXX X XXXXX XXX XXX X
X           X   X   X X X X X   X           X     X   X   X X
X XXXXXXXXX X XXXXXXX X X X X XXXXXXXXXXXXX XXXXX XXX XXXXX X
X X         X   X   X X   X   X           X   X   X X       X
X X XXXXXXXXX X X X X XXXXX XXXXX XXXXXXX XXXXX XXX XXXXXXX X
X X       X   X   X X     X     X     X X       X           X
X XXXXXXX XXXXXXXXX X XXX XXXXX XXXXX X XXXXXXXXX XXXXXXX XXX
X X     X   X       X X X     X     X X         X X X   X X X
X X XXXXXXX X XXXXXXX X X XXXXXXXXX X XXX XXXXX X X X X X X X
X X       X X X     X   X X       X X   X X   X X X X X X   X
X X XXXXX X X X X XXXXX X X XXXXX X XXX X XXX X X X X X XXX X
X X   X X     X X       X X X     X X   X   X X X   X X   X X
X XXX X XXXXXXXXXXXXX XXX X X XXXXX X XXXXX X X XXX X XXX X X
X X         X       X   X   X       X X       X     X X   X X
X X XXXXXXXXX XXXXX XXXXX XXXXXXXXXXX XXXXXXX XXXXXXX X XXXXX
X X X X   X   X   X     X X   X     X       X   X X   X     X
X X X X X X XXX X XXXXX X XXX X X XXX XXXXX XXX X X XXXXXXX X
X X   X X X X X X     X X   X   X   X X   X X X   X X   X   X
X XXXXX X X X X X XXX X XXX XXX XXX X X X X X XXX X X X X X X
X       X   X   X X   X   X   X   X   X X X X     X X X X X X
XXXXXXXXXXXXX XXX XXXXXXX XXX XXXXXXX X X X XXXXX X X X X X X
X           X   X X     X   X X     X   X X     X X X X   X X
X XXXXX XXXXXXX X X XXX XXX X X XXX XXX XXXXXXX XXX X XXXXX X
X   X X         X   X     X X   X X X   X     X     X X     X
XXX X XXXXXXXXXXXXXXX XXX X XXXXX X XXXXX XXX XXXXX X X XXXXX
X   X X             X   X X   X   X     X   X     X X X     X
X XXX X XXXXX XXXXX XXX X XXX X XXXXXXX XXX XXXXX X X XXXXX X
X X   X X   X X     X   X X   X     X   X   X     X X   X X X
X XXX X X X X XXXXXXX XXX X XXXXX XXX XXX XXX XXXXXXXXX X X X
X   X   X X   X   X   X X X     X   X X   X X X       X X   X
XXX XXX X XXXXX X X XXX X XXXXX XXX X X XXX X X XXXXX X X XXX
X X   X X X     X   X         X   X X   X   X   X   X   X   X
X XXX XXX X XXXXX XXXXXXXXXXXXXXX X XXXXXXX XXXXXXX XXXXXXX X
X X       X X   X X       X   X   X           X     X     X X
X X XXXXXXX X XXX X XXXXX X X XXXXX X XXXXXXX X XXX X XXX X X
X   X       X     X   X   X X     X X   X   X   X X X   X   X
XXXXX XXXXXXXXXXX XXX X XXX XXX XXX XXX X X XXXXX X XXX XXXXX
X     X         X X   X X   X X   X X X   X   X   X   X   X X
X X XXX XXXXXXX XXX XXX X XXX XXX X X XXXXXXX X XXXXX XXX X X
X X X   X     X X   X   X   X   X X       X X X         X   X
X XXX XXX XXX X X XXX XXXXX X X X XXXXXXX X X XXXXXXXXXXXXX X
X         X   X     X         X X           X               K
XXXXXXXXXXXXXXXXXXXXXXXXXXXXXXXXXXXXXXXXXXXXXXXXXXXXXXXXXXXXX
