XXXXXXXXXXXXXXXXXXXXXXXXXXXXXXXXXXXXXXXXXXXXXXXXXXXXXXXXXXXXXXXXXXXXXXXXXXXXXXXXXXXXXXXXXXXXXXXXXXXXXXXXXXXXXXXXXXXXXXXXXXXXXXXXXXXXXXXXXXXXXXXXXXXXXXXXXXXXXXXXX
P     X         X               X                   X X       X         X         X     X       X     X                   X                 X       X           X
X XXX X X XXXXXXX XXXXXXXXXXX X XXXXXXXXXXXXXXX XXX X X X XXX X XXX XXX X XXXXXXX XXXXX X XXX X X X XXX XXXXXXXXXXXXXXX X XXXXXXX XXXXX XXX XXXXX XXX XXXXX XXX X
X   X   X X       X       X   X             X   X X   X X   X X   X X   X     X   X     X   X X X X     X         X   X X X     X     X X       X X   X   X X X X
XXX XXXXX X XXXXXXX XXXXX X XXXXXXXXXXXXXXX X XXX XXX X XXX XXXXX X XXX X XXX X XXX XXXXXXX X XXX XXXXXXX XXXXXXX X X X X X XXX XXXXX X XXXXXXX X X XXX XXX X X X
X   X   X   X X   X X   X   X       X   X     X       X   X       X   X X   X X   X         X     X   X     X   X   X X X   X     X X X     X   X       X   X X X
X XXXXX XXXXX X X X X X XXXXX XXXXX X XXX XXXXXXXXXXXXXXX XXXXXXX XXX X X XXX XXX XXXXXXX XXXXXXXXXXX X XXX XXX XXXXX X XXX XXXXX X X XXXXX X XXXXXXXXX X XXX X X
X X         X X X   X X   X   X   X   X   X X           X X X   X   X X   X   X         X   X       X   X   X   X X   X   X X   X X     X   X X       X X   X X X
X XXX XXXXX X X XXXXXXX X X X X X XXXXX XXX X XXXXXXXXX X X X X XXXXX XXX X XXXXXXXXXXX XXX X XXXXX XXXXX XXX X X X XXXXX X X X X XXXXXXX XXX X XXXXX XXXXX X X X
X   X     X X X       X X   X X X     X     X     X     X X X X     X X X X           X   X   X X   X   X X   X   X X   X X X X X         X   X X         X X   X
XXX X XXX X X XXXXXXX XXXXX X X XXXXX XXXXX XXXXX X XXX X X X XXXXX X X X X XXXXX XXX XXX XXXXX X XXX X X X XXXXXXX X X X XXX X XXXXXXXXXXX XXX XXXXXXXXX X XXX X
X X X   X X X   X   X     X X       X       X   X X X   X X X   X X   X   X X   X X   X   X     X X   X   X X       X X X X   X     X     X X   X   X     X   X X
X X XXXXX X X X X X XXXXX XXXXXXXXXXXXX XXXXX X X X X XXX X XXX X XXXXX XXXXX X X X XXX XXXXX X X X XXXXXXX X XXXXXXX X X X XXXXXXX X XXX X X X X X X XXXXXXX X X
X   X     X X X   X     X     X       X       X X X X X   X   X X     X X     X X X X X     X X     X       X X   X   X   X   X   X X   X X X X   X X   X     X X
X XXX XXXXX X XXXXXXXXX XXXXX X XXXXX XXXXXXXXX X X XXX XXX XXX XXXXX X X XXXXX XXX X XXXXX X XXXXXXXXXXX XXX X X X XXXXX X XXX X X XXX XXX XXXXXXX XXX X XXXXX X
X X   X     X         X   X   X     X X       X X X     X     X X   X X   X         X   X X X X         X   X   X X     X X X   X X   X       X   X X X   X X   X
X XXX XXXXX XXXXXXXXX X XXX X XXXXX X X X XXXXX X XXXXXXX XXX X X X X XXXXX XXXXXXXXX X X X XXX XXXXXXX X X XXXXX XXXXX X X X XXX XXX XXXXXXX X X X X XXXXX X XXX
X X   X   X     X     X X   X     X X X X X     X   X   X X   X   X X       X   X     X   X X   X X   X X X     X     X X X X X     X   X   X   X   X       X X X
X X XXX X XXXXX X XXXXX X XXXXXXX X X X X X XXXXXXX X XXX X XXXXXXX XXXXXXXXX X X X X XXXXX X XXX X X X X XXXXX XXXXX X XXX X XXXXX XXX X X XXXXXXXXX XXX XXX X X
X X     X X X   X X   X X       X X X X X X X X   X X     X     X   X   X     X X X X X     X X   X X   X     X   X   X   X X   X     X   X X   X   X X   X   X X
X X XXXXX X X XXX X XXX XXXXXXX XXX X XXX X X X X X X XXXXXXX XXX X X X X XXXXX XXX XXX XXXXX X XXX XXXXXXXXX XXX X XXXXX X XXX XXXXX X XXX X X X X X X XXX XXX X
X X X   X X   X   X X   X     X X   X   X     X X   X X     X X   X X X X X   X   X   X   X   X         X X   X   X X   X     X     X X X   X X   X X X     X   X
X X X X X X XXXXX X X XXXXXXX X X XXXXX XXXXX X XXXXX X XXXXX X XXXXX X X X XXXXX X X XXX X XXX XXXXXXX X X XXX XXX X X XXXXXXXXXXX X XXX XXX XXXXX X XXXXXXX X X
X X   X X X       X X   X   X X X X   X     X X X     X X     X       X   X   X   X X   X X X   X   X X X     X X     X X           X     X   X   X X         X X
X XXXXXXX XXXXXXXXX XXX X X X X X X XXXXXXX XXX X XXXXX X XXX XXXXXXXXXXXXXXX X X XXXXX X X X XXX X X X XXXXXXX X XXXXXXX XXXXXXXXXXXXXXXXX XXX XXX XXXXX XXX X X
X   X     X   X   X   X   X X X   X X       X   X       X   X X X     X       X X X   X     X X   X X   X     X     X     X   X             X     X   X X X   X X
XXX X XXXXX X X X X X XXXXX X XXXXX X XXXXX X XXXXXXXXXXX X X X X X X X XXXXX X XXX X XXXXXXXXX XXX X XXX XXX XXXXXXX XXXXX X XXXXXXX XXXXXXXXXXX XXX X X X XXX X
X X X   X   X X X X X   X   X     X X   X   X           X X X X   X X X X   X X   X X             X X X   X X         X     X         X           X   X X   X X X
X X XXX XXX X X X XXXXX X XXXXX X X XXX XXXXXXXXXXXXXXX X X X XXXXX X X XXX X XXX X XXXXXXXXXXXXXXX X XXX X X XXXXXXXXX XXXXXXXXXXXXXXX XXXXX XXX X XXX XXXXX X X
X X     X   X   X       X X     X     X               X X X X       X   X   X   X   X       X   X   X     X   X     X     X       X   X     X X   X       X X   X
X XXXXXXX XXXXX XXXXXXXXX X X X XXXXXXX XXXXX XXXXXXX X X X XXXXXXXXXXXXX X XXX XXXXX XXXXX X X X X XXXXXXXXX X XXX XXXXX XXXXX XXX X XXXXX X X XXXXXXXXX X X XXX
X         X     X         X X X X     X X   X   X     X X X               X   X       X   X   X X X X       X X X X X   X     X   X X   X   X X         X   X X X
X XXXXXXX XXXXXXX XXXXXXXXX X X X XXX X XXX XXX XXXXXXX XXX XXXXX XXXXX X X X XXXXXXX X X XXXXXXX XXX XXXXX XXX X X X X X XXX X X X XXX X XXX X XXXXXXXXXXX X X X
X X             X     X   X X   X X   X       X   X   X   X     X X   X X X X     X   X X       X X       X X     X   X X X   X X     X   X X X X           X X X
X X XXX XXXXX X XXXXX X X X XXXXX X XXXXXXXXX XXX X X XXX XXXXXXX X X XXX X X XXX X XXX XXXXXXX X X XXXXXXX X XXXXXXXXX X X XXX XXXXXXXXX X X XXX XXXXXXXXX X X X
X X   X X   X X     X   X   X   X X         X X X X X   X   X     X X     X X   X     X X   X   X X   X     X X X     X X X   X X X     X   X         X   X X   X
XXXXX X X X XXX X XXXXXXXXX X X X XXXXXXXXX X X X X X XXXXX X XXXXX X XXXXX XXX XXXXXXX XXX X XXX X XXX XXXXX X X XXX X X XXX X X X XXX XXX XXXXXXXXXXX X XXXXX X
X     X   X     X X       X X X   X X     X X   X         X X   X   X X   X   X     X   X   X X     X   X   X   X   X   X X   X   X X X   X     X X   X X       X
X X XXXXXXXXXXX XXX XXXXX X X XXXXX X X XXX XXXXXXXXXXX X X X X X XXXXX X XXX XXXXX X XXX X X XXXXXXX X X X XXX XXX XXXXX X XXXXXXX X XXX XXXXX X X X X XXXXXXXXX
X X X     X X   X   X     X X     X   X     X     X   X X   X X X   X   X   X X     X X   X X X       X X X       X X     X     X   X   X   X   X X X   X   X   X
X XXX XXX X X XXX XXX XXXXX XXXXX XXXXX XXXXX XXX X X XXXXX XXX X X X XXXXX XXX XXXXX XXX XXX X XXXXXXXXX XXXXXXXXX XXX XXXXXXX X XXX X XXX X XXX X XXXXX X XXX X
X X     X X X X   X X     X   X   X   X   X   X   X X     X     X X X     X X   X     X   X   X X   X   X X   X   X   X       X   X   X X   X   X X       X   X X
X X XXXXX X X X XXX XXXXX XXX X XXX X XXX X XXX XXX XXXXX XXXXXXX X XXXXX X X XXX XXXXX XXX XXX X X X X X X XXX X X X XXXXXXXXXXX XXX XXX XXXXX X XXXXXXXXXXX X X
X X X X   X   X         X   X X     X X X X X   X X   X   X   X   X       X X   X     X X   X   X X   X     X   X X X X   X     X   X   X     X   X   X       X X
X X X X XXXXXXXXXXXXXXX XXX X XXXXXXX X X X X XXX X X X XXX XXX XXXXXXXXXXX XXX XXXXX X X XXXXX X XXXXXXXXXXX XXX X X X X X XXX XXX X X XXXXX XXXXX X X XXXXXXX X
X X X X                 X X X     X X X X X X   X X X X X             X   X     X   X X   X     X   X   X X   X X X X   X   X X X   X X   X X       X X     X   X
X X X XXXXXXXXXXXXXXXXXXX X XXXXX X X X X X XXX X X X X XXXXX XXXXXXXXX X XXXXXXX X X X XXX XXXXXXX X X X X XXX X X XXXXXXXXX X X XXXXX X X XXXXXXX X XXXXX X X X
X X X             X       X         X X X   X   X   X X     X X         X         X   X   X   X       X   X   X   X   X       X X X     X X   X   X X     X X X X
X X X XXXXX X XXX XXXXXXX XXXXXXXXXXX X XXXXX XXXXX X XXXXX X X XXXXXXXXXXXXXXXXXXXXXXXXX XXX X XXXXXXXXXXXXX X XXXXX X X X XXX X X XXXXX X XXX X X XXXXX X X X X
X X X X   X X   X         X X   X     X     X X   X X   X X X X       X     X       X     X   X   X     X     X   X X X X X X   X   X       X   X X X   X X X X X
X X XXX X XXXXX XXXXXXXXX X X X X XXXXX XXX X X X XXXXX X X X XXXXXXX X XXX XXXXXXX X XXXXX X XXX X XXX X XXXXXXX X X X X XXX XXX XXXXXXXXX X XXX XXX X X X X X X
X X   X X X     X         X X X   X     X   X   X       X   X       X X X X X     X X X     X   X X X X   X X     X   X X X   X X X         X   X     X   X   X X
X XXX X X X X XXXXXXX XXXXX X X XXXXXXX X XXXXXXXXXXXXXXX XXX XXXXXXX X X X X XXX X X XXX XXXXXXX X X XXXXX X XXXXXXX XXX X XXX X X XXX X XXXXX XXXXXXXXX XXXXX X
X   X   X X X X     X       X X X     X X           X X   X   X   X   X X X X X X X       X   X   X X       X   X   X     X   X   X X X X   X X X   X   X   X X X
X X XXXXX X X X XXX XXXXXXX X XXX XXX XXXXXXX XXXXX X X XXXXXXX X X X X X X X X X XXXXXXX X X X XXX X XXXXX XXX X X XXXXX XXX XXXXX X X XXX X X X X X X XXX X X X
X X     X X X X   X       X X     X   X     X X X     X X       X X X X X X X X X   X     X X X   X X     X     X X X       X         X   X X X   X X X   X X X X
X X XXXXX X X XXX XXXXXXX XXXXXXXXX XXX XXX X X X XXXXX X XXXXXXX X XXX X X X X XXX XXXXXXX X XXX X XXXXX XXXXXXX X XXXXXXXXX XXXXXXXXXXX X X XXXXX XXX X X X X X
X X X     X X   X   X     X   X   X X   X X X X   X     X     X   X   X X X   X   X         X   X X     X X       X X       X X           X     X X   X X   X X X
X X X XXXXX XXXXXXX X XXXXX X X X X X XXX X X XXX X XXXXXXXXX X XXXXX X X XXXXX X XXXXXXXXXXXXX X XXXXX X X XXXXXXX X XXXXX X X XXXXXXXXXXXXXXX X XXX X XXXXX X X
X X X   X   X     X X       X X X   X   X X X   X X         X X X   X X X       X       X X     X     X X   X   X X   X   X X X   X         X X X X   X X     X X
X X XXX XXX X X X X XXXXXXXXX X X XXXXX X X XXX XXXXXXXXXXX X X X X X X XXXXXXXXXXX XXX X X XXXXX XXXXX X XXX X X XXXXX XXX X XXX XXXXX XXX X X X X XXX X XXX X X
X X   X   X   X X X     X   X X X X     X X   X               X X X X X       X   X   X X X X     X   X X X   X X       X   X X X X     X   X X X X X X X   X X X
XXXXX XXX XXX X X XXXXX X XXX X X X XXXXX XXX XXXXX XXXXXXXXXXX X X X XXXXXXX X X XXX X X X X XXXXX X X X X XXX XXXXXXX X XXX X X X XXXXX XXX X X X X X XXX X X X
X       X   X X X X     X     X X X X       X     X X   X   X   X X         X   X X   X   X X X X   X   X X   X X     X X   X   X X   X       X X X X       X X X
X XXXXXXXXX X X X X XXXXXXXXX X XXX X XXXXX XXXXX X X XXX X XXX X XXX XXXXXXXXXXX X XXXXX X X X X XXXXXXXXXXX X X XXX X XXX XXX X XXX XXXXXXX X X X XXXXXXXXX X X
X     X     X X X X     X   X X X   X X   X     X X   X   X   X   X   X           X   X   X X   X   X         X     X X   X X   X   X     X   X X X     X     X X
X XXX X XXXXXXX XXXXXXX X X X X X XXX XXX XXXXX X XXXXX XXXXX X XXXXXXX XXXXX XXXXX X X XXX XXX XXX X XXXXXXXXXXXXX X X X X X XXXXX XXXXX XXX X X XXXXX XXXXXXX X
X   X           X     X   X X X   X         X   X     X     X X X       X   X     X X X   X   X X X X X X       X X X X X   X X   X     X   X X X     X   X     X
X XXXXXXXXXXXXXXX XXX X XXX X X XXXXXXXXXXXXX X XXXXX XXXXX X XXX XXXXXXX X XXXXX XXX XXXXX XXX X X X X X XXXXX X X X X XXXXX XXX XXXXX XXX XXX X XXX XXX X XXXXX
X X     X         X X X   X X X           X   X   X X X     X   X X   X   X     X     X   X   X X X     X X X   X   X X X     X   X   X   X   X X X   X   X     X
X X XXX X XXXXXXXXX X XXX X X XXXXXXXXXXX X XXXXX X X X XXXXXXX X X XXX XXXXXXX XXXXXXX X XXX X X XXXXXXX X X XXX XXX X X XXXXX X X XXXXX XXX X XXX XXX X XXXXX X
X X   X   X     X   X X   X X X       X   X X   X X X X       X X X X   X     X       X X X   X X     X   X   X   X   X X     X X   X     X   X X   X   X     X X
X XXX XXXXX XXX X XXX XXXXX X XXX X XXX XXX XXX X X X XXXXX XXX X X X XXX XXX XXXXXXX X X X XXX X XXX X XXX XXXXX X XXX XXXXX X XXXXX XXXXX XXX X XXX XXXXXXXXX X
X   X   X   X   X X   X   X X X   X X   X     X     X X     X   X   X   X X X         X X X     X X   X   X     X X X   X   X X X     X   X     X   X     X     X
XXX XXX X XXX XXX X XXX X X X X XXX X XXX XXX X XXXXX X XXXXX XXXXX XXX X X XXXXXXXXXXX X XXX XXXXX X XXX XXXXX XXX X XXX X X X X X XXX X X XXXXX X XXXXX X X XXX
X X   X     X   X       X   X X X   X X   X   X X     X   X X     X X   X     X   X     X   X   X   X X   X   X X   X     X X X X X X   X X X     X   X   X X   X
X XXX XXXXXXXXX XXXXXXXXXXXXX X XXX X XXXXX XXX X XXXXXXX X XXXXX X X XXXXXXX X X XXXXX XXX XXX X XXX X XXXXX X X XXXXXXXXX X X X XXX XXX X X XXXXXXX X XXX X X X
X   X   X     X     X     X   X   X X       X X X X     X       X X X   X   X   X X     X   X     X   X     X X X X   X   X X   X X   X   X X   X     X X   X X X
XXX XXX X XXX XXXXX X XXX X XXXXX X XXXXXXXXX X X X XXX XXXXXXX X X XXX X X XXXXX X XXXXX XXXXXXXXXXXXXXXXX X X X X XXX X X XXXXX X XXX XXX XXX X XXXXX X XXXXX X
X   X   X X X X     X X X   X   X X X   X     X X   X X     X   X   X X X X X   X X   X X   X               X   X X     X         X X   X   X   X X     X X     X
X X X XXX X X X XXXXX X XXXXX X X X X X X X X X XXXXX XXXXX X XXXXXXX X X X X XXX XXX X XXX X XXXXXXXXXXXXXXX XXX XXXXXXXXXXX XXXXX X XXX XXX XXX X XXX X X XXX X
X X X X   X     X   X X       X   X   X X X X X     X   X X     X   X X   X X     X   X X   X X             X X   X     X   X X     X X   X   X X X   X X X X X X
X XXX X XXXXXXXXX X X XXXXX X XXXXXXXXXXX X XXXXXXX X X X XXXXX X X X XXXXX X XXXXX XXX X XXX X X XXXXXXXXXXX X X X XXX X X XXX XXXXX XXX XXX X X XXX XXX X X X X
X     X     X     X     X   X X   X     X X       X   X   X   X   X X     X X X     X X   X   X X X             X X X X   X   X   X X   X   X   X   X   X   X X X
X XXXXX XXX X XXXXXXXXX X X XXX X X XXX X XXXXX XXXXXXX XXX X XXX X XXXXX X X X XXXXX X XXX XXX X X XXXXXXXXXXXXX X X XXXXXXX XXX X XXX XXX XXXXXXX XXX XXXXX X X
X X   X X   X           X X X   X X   X X   X   X     X X   X X   X X     X X   X       X     X X   X         X X X   X     X   X X   X   X X         X       X X
XXX X XXX XXX XXXXXXXXXXX XXX XXX XXX X XXX X XXX XXX X X XXX X X X X XXXXX XXXXX X XXXXX XXX XXXXX X XXXXXXX X X XXX XXX XXX XXX X XXXXX X X XXXXXXX XXXXX XXX X
X   X   X   X   X X       X   X X     X   X X   X X X X X   X   X X   X     X     X X     X X     X X     X   X X   X   X   X       X     X X   X       X   X   X
X XXXXX XXX XXX X X X XXXXX XXX XXXXXXXXX X XXX X X X X XXX XXXXX X XXX XXXXX X XXX X XXXXX XXXXX XXXXXXX X XXX XXX XXX XXX XXXXXXXXX XXXXX XXX X XXXXX X XXX XXX
X X   X     X   X   X       X       X     X   X X   X   X   X X   X X   X     X     X         X X X   X   X   X       X       X       X     X   X X   X X X   X X
X X XXXXXXXXX XXXXX XXXXXXX X X XXXXX XXX XXX X XXX XXXXX XXX X XXXXX XXX XXXXXXXXXXXXXXXXXXX X X X X X XXXXX XXXXXXXXXXXXX XXX XXXXXXX XXXXX XXXXX X XXX X XXX X
X X X       X     X   X   X X X X     X     X X   X   X   X   X   X   X X X     X     X     X   X   X   X   X   X           X   X X   X X   X     X X   X   X   X
X X X XXX XXXXXXX XXXXX X X X X X XXXXX XXXXX XXX X XXX XXXXX XXX X XXX X XXX X X XXX XXXXX X XXXXX XXXXX X XXX X XXXXXXXXXXX XXX X X X X X X XXX X XXX XXXXXXX X
X X     X X     X X   X X X   X X X   X X   X X   X X   X   X   X X X   X X   X   X X X   X   X   X       X   X X   X   X   X   X X X   X X   X   X X X       X X
X XXXXX X X X XXX X X X X XXXXX X X X XXX X X X XXX X XXX X XXX X X X XXX X XXXXXXX X X X XXXXX X XXX XXXXXXXXX XXX X X XXX XXX X X XXXXX XXXXX XXX X XXXXX X X X
X X   X X   X       X X X   X   X   X     X X X   X X     X   X X X X     X     X   X   X     X X X X X     X   X X   X       X X   X   X X   X   X   X   X X X X
X X X XXXXX XXXXXXXXX X XXX X XXXXXXX XXXXX X XXX X XXXXXXX X X X X XXX XXXXXXX X X XXXXXXXXX X X X X X XXX X X X XXXXXXXXXXX X X XXX X X XXX XXX XXX X XXX X X X
X X X     X   X     X   X X X   X   X X   X X   X     X   X X X X X   X   X     X X         X   X X X X X     X   X         X X X X   X X       X     X X   X   X
X X XXXXX XXXXX XXX XXXXX X XXXXX X X X X X XXX XXXXXXX X XXX X X XXX XXX X XXXXX XXXXX XXX XXXXX X X X XXXXX XXXXX X XXXXXXX X X XXX X XXXXX XXXXX XXX X XXXXX X
X X   X     X   X     X     X   X X X   X X       X   X X     X X     X X X     X X     X X X   X X   X   X   X     X   X     X X   X X       X   X X   X   X X X
X XXX XXXXX X XXXXXXX X XXXXX X X X XXXXX XXXXXXXXX X X XXXXXXX XXXXXXX X XXXXX X X XXXXX X XXX X X XXXXX X XXX XXXXXXX X XXXXX XXX XXX XXXXXXX X X X XXXXX X X X
X   X X   X X     X   X     X X   X X   X   X   X   X X X   X           X     X X X X X     X   X X   X X X   X     X X     X   X     X X X     X X   X     X X X
XXX X X X X XXXXX X XXXXXXX X XXXXX X X XXXXX X X XXX X XXX X XXXXX XXX XXXXX X X X X X XXX X X X XXX X X XXXXXXXXX X XXXXXXX XXX XXX X X X XXXXX X XXX XXXXX X X
X   X   X X       X X     X X   X     X   X   X X   X X X   X X   X X X X   X   X X X   X     X X   X   X         X X     X   X   X   X   X X   X X X   X       X
X X XXXXX XXXXXXXXX XXX X X XXX XXXXXXXXX X XXX XXX X X X XXX XXX X X X X XXXXXXXXX X XXX XXX XXXXX XXXXX X XXX XXX X X XXX XXX X X XXXXX X XXX X XXX XXX XXXXXXX
X X     X     X   X   X X X   X     X X   X   X     X   X         X X   X           X X   X   X     X     X X   X   X X X   X   X X X   X X X   X     X X       X
X XXX XXXXXXXXX XXXXX X XXXXX XXX X X X XXXXX XXXXXXXXXXXXXXXXX XXX X XXXXXXXXX XXXXX X XXXXXXX XXXXX XXX XXX XXX XXX X X XXX X X X X X XXX X XXXXXXXXX XXXXXXX X
X   X X   X           X     X   X X X   X     X X         X   X X   X           X     X   X     X     X     X   X X   X X X   X X X   X     X X       X       X X
XXX XXX X X XXXXXXXXXXX XXX XXX XXX X XXX X XXX X X XXXXX X X XXX XXXXXXXXXXXXXXX XXXXXXX X XXXXXXX X XXXXX XXX X X XXX X X XXX XXXXXXXXXXXXX X XXX X X X XXX X X
X   X   X   X         X X X   X X   X   X X X     X X       X   X     X X                 X   X     X X   X     X   X   X X X   X   X       X   X   X X X   X X X
X XXX XXXXXXX XXX XXXXX X X XXX X XXXXX X X X XXXXX XXXXXXXXXXX XXXXX X X XXXXXXXXXXX XXXXXXX X XXXXXXX X XXXXXXXXXXX XXX X X XXX X X XXX XXX XXX XXX XXXXX XXX X
X X   X     X   X       X X     X   X   X X X     X         X X       X X     X     X X     X X         X X         X X X X X     X     X X   X X   X   X   X   X
X X XXX XXXXXXX XXXXXXXXX XXXXXXXXX X XXX X XXXXX XXXXXXXXX X XXXXXXXXX XXXXX X XXX XXX X X X X XXXXXXXXX X XXX XXXXX X X XXX XXXXX XXXXX X XXX XXX XXX X X X XXX
X   X   X     X X   X         X   X X   X X X   X X         X     X       X   X X X     X X X X         X X   X X     X X   X X   X   X     X   X X X   X X X X X
XXXXX XXX XXX X X X X XXXXXXX X X X XXX X X X X X X XXXXXXXXX XXX XXX XXXXX XXX X XXXXXXX XXX XXXXX XXXXX XXX X X XXXXX XXX X X X XXX X XXX X X X X XXX X XXX X X
X     X   X X   X X   X X     X X   X   X X X X   X         X X       X     X X X       X     X   X X   X   X X X   X   X   X X X   X X     X X   X   X   X   X X
X X XXX XXX XXXXX XXXXX X XXXXX XXXXX XXXXX XXXXXXXXX XXXXX X X XXXXX X XXXXX X XXX X XXXXXXXXX X XXX X XXX X X XXX X X X XXXXX XXX X XXXXXXX XXXXXXX X XXX XXX X
X X   X X   X   X     X         X     X   X     X   X   X   X X X   X X   X   X   X X       X   X     X   X   X   X   X X       X X X X     X X     X X X   X   X
XXXXX X X X XXX X XXX XXXXXXX XXXXXXX X X XXXXX X X XXXXX XXX XXX X X XXX X X XXX X XXXXX XXX X X XXXXXXX XXXXX XXXXXXX XXXXXXXXX X X X XXX X X XXX X X X XXXXX X
X     X X X   X     X   X     X     X   X       X X     X X   X   X X   X   X   X X   X X   X X X   X   X X     X   X   X         X X X X     X X     X X     X X
X XXX X X XXX XXXXX XXX XXXXXXX XXX XXXXXXXXXXXXX XXXXX X XXX X XXX XXXXXXXXXXX X XXX X XXX X X X XXX X X X XXXXX X X XXX XXX XXX X X X XXXXXXX X XXXXXXXXXXX X X
X X X X   X X   X   X   X   X   X X   X           X   X X X   X X X           X X X       X   X X     X   X       X   X     X X X X X   X   X   X X     X     X X
X X X XXXXX XXX X XXX X X X X XXX XXX XXXXX XXXXX X X X X X XXX X XXXXXXXXXXX X X XXXXXXXXXXXXX XXXXX XXXXX XXXXXXXXXXXXXXXXX X X X XXXXX X X X XXX XXX X XXXXX X
X X   X   X   X X X   X X X   X     X     X X   X   X X   X   X     X     X X X X     X   X   X X   X X   X     X             X   X       X X X X   X X   X     X
X X XXX XXX X X XXX XXX X XXXXX X X XXXXX XXX X X XXX XXXXXXX XXXXX X XXX X X X X XXX X X X X X X X X X XXXXXXX X XXXXXXXXXXXXXXXXXXXXX XXX X XXX XXX XXXXXXXXX X
X X     X   X   X   X   X X     X X   X X     X X X X X     X   X   X X     X       X   X X X X   X X X       X   X         X         X   X X   X     X       X X
X XXXXX X XXXXXXX XXX XXX XXX XXX XXX X XXXXXXX X X X X XXX X X X XXX X XXXXX XXXXXXXXXXX X X XXXXX X XXXXXXX XXX X XXXXXXX X XXXXXXX XXXXX XXX XXXXX X XXXXX X X
X   X   X X   X     X   X   X   X   X X   X   X X   X   X   X X X   X X X   X   X       X   X       X       X   X X X X   X   X     X     X   X X     X X   X   X
X X XXX X X X X XXX X XXXXX XXX XXX X X X XXX X XXXXXXXXX XXXXX XXX X XXX X XXXXX XXX XXXXXXXXXXXXXXXXXXXXX XXX X X X X X XXXXX XXX XXXXX X X X X XXXXX X X XXX X
X X   X X X X   X   X X   X   X X X X   X     X         X     X   X X   X X       X X                   X X   X   X X X X X     X   X   X X X X X       X X     X
X XXX XXX X XXXXX XXXXX X XXX X X X XXXXXXXXX XXXXXXXXX XXXXX X X X XXX X XXXXXXXXX XXX XXXXXXXXXXXXXXX X XXX XXX X X X X X X XXXXX XXX X XXX X XXXXXXXXX XXXXXXX
X   X     X     X X     X     X X X X       X X       X X     X X       X       X   X X     X       X X X   X   X X X   X   X     X     X   X X         X X     X
XXX XXXXXXXXXXX X X XXXXXXXXXXX X X X XXXXX X X XXXXX X X XXXXXXXXXXX XXXXXXXXX X X X XXXXX X XXXXX X X X X XXX XXX X XXXXXXXXXXX XXXXXXXXX X X XXXXXXX X X XXXXX
X   X     X     X X   X   X   X   X X     X X X X   X X X           X X       X   X       X X   X     X X X   X   X X           X         X   X   X     X X     X
X XXX X XXX XXXXX XXX X X X X XXXXX X XXX XXX X X X X X XXX XXXXXXX XXX X XXXXXXX XXXXXXXXX XXX XXXXX X X XXX XXX X XXXXXXXXXXX XXXXXXXXX XXXXXXX X XXXXX XXXXX X
X X   X X   X       X   X   X   X   X   X       X X   X   X X     X     X       X X       X X   X   X X   X     X X     X               X     X   X     X     X X
X X XXX X XXX XXXXX XXXXXXXXXXX X XXXXX XXXXXXXXX XXXXXXX X X XXX XXXXXXXXXXXXX X X XXXXX X X XXX X XXX XXXXXXXXX X XXX X XXXXXXXXX XXXXX XXX X XXXXXXXXXXXXX X X
X X X   X X X   X X X         X   X   X   X     X X   X   X   X   X   X       X X X   X     X     X   X X   X   X X   X X   X     X X       X   X         X   X X
X X X X X X XXX X X X XXXXX XXXXX X X XXXXX XXX XXX X X XXXXXXXXXXX X X XXXXX X X XXX XXXXXXXXXXXXXXX X X X X X X XXXXX XXXXX XXX XXX X XXX XXX X XXXXX XXX XXX X
X X X X X     X X   X X   X X     X X   X   X   X   X   X   X       X   X   X   X X X     X         X   X X   X X     X     X X   X   X   X   X X     X X   X   X
X XXX XXXXXXX X XXX X X X X X XXXXX XXX X XXX XXX XXXXXXX X X XXXXXXXXXXX X XXX X X XXXXX X XXXXXXX XXXXX XXXXX XXXXX X XXX X X XXX XXXXX XXX X XXXXX X X XXX X X
X   X     X   X   X X X X X X X   X X   X   X     X       X   X       X   X X   X X     X X X     X   X   X   X   X X X X   X X     X     X   X X     X   X   X X
XXX XXX X X XXXXX X XXX X X X XXX X X XXXXX XXXXXXX X XXXXXXXXX XXX XXX XXX X XXX X X XXX X XXX X XXX X XXX X X X X X XXX XXX XXXXXXX XXXXX XXXXX XXXXXXXXXXX XXX
X   X   X X X   X X X   X   X     X X     X X   X   X     X     X X     X X     X   X X   X     X   X   X   X X X   X X   X   X       X   X       X         X   X
X XXX XXXXX XXX X X X XXXXXXXXXXX X XXXXX X X X X XXXXXXX X XXXXX XXXXXXX XXXXXXXXX XXX X XXXXXXXXX XXXXX XXXXX XXX X X XXX XXX XXXXXXX X X XXXXXXXXX XXXXX X X X
X X   X         X X   X     X     X   X X X   X X X   X   X X   X         X     X   X   X       X   X     X     X   X X       X X   X   X X X         X     X X X
X X X X XXXXXXXXX X XXX XXX X XXXXXXX X X XXX X X XXX X XXX X X XXX XXX X X XXX X XXX XXXXXXXXXXX XXX XXXXX XXXXX XXX XXX XXXXX X X X XXX X X XXXXXXXXX XXXXXXX X
X X X X   X     X X X   X X         X X     X X X X   X   X X X   X X   X X X X X   X             X   X     X   X   X   X   X   X X   X X   X X     X X   X     X
X X X X XXX XXX X XXX XXX XXXXXXXXXXX XXXXX XXX X X XXXXX X X XXX X X XXX X X X XXX XXXXX XXXXXXXXX XXX XXXXX XXXXX XXX XXXXX XXX XXXXX XXXXX XXX X X XXX X X XXX
X X X   X   X X X X   X     X       X   X   X   X   X     X X   X X X X   X X X     X             X   X   X       X   X X   X X   X       X   X   X   X   X X   X
X XXX XXX XXX X X X XXX XXX X XXXXX XXX X XXX XXXXX X XXXXX XXX X XXX XXXXX X XXXXXXXXXXXXX XXXXXXX X XXX X XXXXX XXX X X X X X XXXXX XXX X XXX XXXXXXX XXXXXXX X
X   X   X   X X X X X   X   X   X   X   X X   X     X   X X   X X     X   X X             X         X   X X     X     X   X   X   X   X X   X     X   X X     X X
XXX X XXXXX X X X X X XXXXXXXXX X XXX XXX XXX X XXXXXXX X XXX X XXXXX X X X XXX XXXXXXXXX X XXXXXXXXX XXX XXXXXXXXX XXXXXXXXXXXXX X XXX XXXXX XXX X X X X X X X X
X X X X     X X X X X   X     X X X   X X X   X     X   X   X   X   X X X   X   X   X     X X     X X   X   X     X       X     X X X       X   X   X   X X X X X
X X XXX XXXXX X X X XXX X XXX X X X X X X X XXXXXXX X XXX XXXXXXX XXX X XXXXX XXXXX X XXXXX XXX X X XXX XXX X XXX XXXXXXX X X X X X X XXX XXXXX XXXXXXXXXXX X X X
X X X   X   X   X       X   X X X X X X   X X     X X   X             X     X   X   X X         X   X X   X   X X   X     X X X X   X X X X   X X   X       X X X
X X X XXX X X XXX XXXXXXX X X X X XXX X XXX X X XXX XXX XXXXXXXXXXXXXXXXXXX XXX X XXX XXXXXXXXXXXXX X XXX XXXXX XXX XXXXXXX X XXXXXXX X X X X X X X XXX XXXXX X X
X   X X   X X X     X   X X X   X   X X X   X X   X   X   X   X     X       X   X   X             X     X     X   X     X   X   X     X X X X X   X     X   X   X
X XXX X XXX X XXXXXXX X XXX XXXXXXX X X X XXX XXX XXX XXX X X X XXX X XXXXXXX XXX X XXXXXXXXXXXXX XXXXXXX XXX X X XXXXX X XXXXX X XXXXX X X X XXXXXXXXXXX X XXX X
X     X   X           X     X         X   X     X       X   X     X           X   X                       X     X     X       X         X   X             X     K
XXXXXXXXXXXXXXXXXXXXXXXXXXXXXXXXXXXXXXXXXXXXXXXXXXXXXXXXXXXXXXXXXXXXXXXXXXXXXXXXXXXXXXXXXXXXXXXXXXXXXXXXXXXXXXXXXXXXXXXXXXXXXXXXXXXXXXXXXXXXXXXXXXXXXXXXXXXXXXXXX
